
__________|
|0|0|00000|
|0|0|0|0__|
|00000|000|
|0____|0__|
|0|000|0|0|
|0|0__|0|0|
|00000|0|0|
|0|__0|0|0|
|0|000|000|
___________

__________|
|000000000|
|0|__0____|
|0|0|000|0|
|0|0|0|0|0|
|0|000|000|
|0|0|0|0|0|
|0|0|0|0|0|
|0|0|0|0|0|
|0|0|0|0|0|
___________

__________|
|00000|000|
|0|__0|0|0|
|0|00000|0|
|0|____0|0|
|0|00000|0|
|0|____0|0|
|0|00000|0|
|0|__0|0|0|
|0|000|0|0|
___________

__________|
|000000000|
|____0____|
|000000000|
|0________|
|0|0|00000|
|0|0|0____|
|0|0000000|
|0|0______|
|000000000|
___________

__________|
|00000|0|0|
|____0|0|0|
|000000000|
|__0______|
|000000000|
|0________|
|000000000|
|0|__0____|
|0|0000000|
___________

__________|
|000000000|
|__0______|
|000000000|
|0|0______|
|0|0000000|
|0|0______|
|0|0000000|
|0|0|0|0|0|
|0|0|0|0|0|
___________

__________|
|000000000|
|________0|
|00000|0|0|
|____0|0|0|
|0|0000000|
|0|0|0____|
|000|00000|
|0__|0____|
|000|00000|
___________

__________|
|0|0|00000|
|0|0|0____|
|000000000|
|0________|
|000|00000|
|0|0|__0__|
|0|0000000|
|0|______0|
|0|0000000|
___________

__________|
|0|0|00000|
|0|0|0____|
|000000000|
|0________|
|000|00000|
|0|0|__0__|
|0|0000000|
|0|______0|
|0|0000000|
___________

__________|
|0|0|00000|
|0|0|0____|
|000000000|
|0________|
|000|00000|
|0|0|__0__|
|0|0000000|
|0|______0|
|0|0000000|
___________

__________|
|0|0|00000|
|0|0|0____|
|000000000|
|0________|
|000|00000|
|0|0|__0__|
|0|0000000|
|0|______0|
|0|0000000|
___________

__________|
|0|0|00000|
|0|0|0____|
|000000000|
|0________|
|000|00000|
|0|0|__0__|
|0|0000000|
|0|______0|
|0|0000000|
___________

__________|
|0|0|00000|
|0|0|0____|
|000000000|
|0________|
|000|00000|
|0|0|__0__|
|0|0000000|
|0|______0|
|0|0000000|
___________

__________|
|000|00000|
|__0|0____|
|000000000|
|0________|
|000000000|
|0|0|____0|
|0|0|00000|
|0|0|0____|
|0|0|00000|
___________

__________|
|000000000|
|__0|__0__|
|000|0|0|0|
|0__|0|0|0|
|000|00000|
|0__|____0|
|000|00000|
|0__|0|0__|
|000|0|000|
___________

__________|
|000|00000|
|__0|0|0|0|
|00000|0|0|
|0____|0|0|
|00000|0|0|
|__0__|0|0|
|00000|0|0|
|0|0__|0|0|
|0|000|0|0|
___________

__________|
|000000000|
|0________|
|000000000|
|0|____0__|
|0|0|0|000|
|0|0|0|0|0|
|0|00000|0|
|0|__0|0|0|
|0|000|0|0|
___________

__________|
|00000|000|
|0|__0|__0|
|0|0000000|
|0|0______|
|0|000|0|0|
|0|0|0|0|0|
|0|0|0|000|
|0|0|0|0__|
|0|0|00000|
___________

__________|
|00000|000|
|0|__0|__0|
|0|0000000|
|0|0______|
|0|000|0|0|
|0|0|0|0|0|
|0|0|0|000|
|0|0|0|0__|
|0|0|00000|
___________
